#include <iostream>
#include <string>
using namespace std;
int main(){
       string a;
       int b;
       
       cin >> a;
       
       b = a.length();
       
       for(int i=0;i<b;i++)
       {
         switch(a[i])
         {
           case 'A': cout << "D";break;
           case 'B': cout << "E";break;
           case 'C': cout << "F";break;
           case 'D': cout << "G";break;
           case 'E': cout << "H";break;
           case 'F': cout << "I";break;
           case 'G': cout << "J";break;
           case 'H': cout << "K";break;
           case 'I': cout << "L";break;
           case 'J': cout << "M";break;
           case 'K': cout << "N";break;
           case 'L': cout << "O";break;
           case 'M': cout << "P";break;
           case 'N': cout << "Q";break;
           case 'O': cout << "R";break;
           case 'P': cout << "S";break;
           case 'Q': cout << "T";break;
           case 'R': cout << "U";break;
           case 'S': cout << "V";break;
           case 'T': cout << "W";break;
           case 'U': cout << "X";break;
           case 'V': cout << "Y";break;
           case 'W': cout << "Z";break;
           case 'X': cout << "A";break;
           case 'Y': cout << "B";break;
           case 'Z': cout << "C";break;
         }
         }
         cout << endl;
         
         return 0;
         }
